block ConstructingBodyBlock 修改为: ManufactureSoundboxKibosh
block POPAnimatablePropertyReadBlock 修改为: DadaAnimatableDimensionLearnBlockage
block POPAnimatablePropertyWriteBlock 修改为: BoltDownAnimatableHoldingPenChokeUp
block POPAnimationCompletionBlock 修改为: POPAnimationCompletionBlock
block POPAnimationDidApplyBlock 修改为: TossOffAlivenessFareEnforceImmobilise
block POPAnimationDidReachToValueBlock 修改为: POPAnimationDidReachToValueBlock
block POPAnimationDidStartBlock 修改为: POPAnimationDidStartBlock
block POPCustomAnimationBlock 修改为: KillTraditionAlivenessBarricade
block UploadProgressBlock 修改为: UploadMarchOnStymy
const Vector2 修改为: TransmitterDeuce
const Vector3 修改为: TransmitterDeuceAce
const Vector4 修改为: TransmitterLittleJoe
const constructingBodyBlock 修改为: ConstructingBodyBlock
const distanceValues 修改为: OutstripTreasure
const fromValues 修改为: FromAppraise
const kPOPAnimatableAllTypes 修改为: KPOPAnimatableEntirelyCase
const kPOPAnimatableSupportTypes 修改为: KPOPAnimatableStomachTypecast
const maxSolverDt 修改为: MaxSolverDt
const previous2Values 修改为: Previous2Values
const previousValues 修改为: FormerAssess
const solverDt 修改为: SolverDt
const supportedVelocityTypes 修改为: SupportedVelocityTypes
const toValues 修改为: ToValues
const velocityValues 修改为: VelocityValues
define AHFloat 修改为: AHFloat
define AH_EASING_USE_DBL_PRECIS 修改为: AH_EASING_USE_DBL_PRECIS
define COLOR_BACKGROUND_ 修改为: PeopleOfColorGround
define COLOR_CIRCLE_ 修改为: COLOR_CIRCLE_
define COLOR_GRAY_FONT_ 修改为: COLOR_GRAY_FONT_
define COLOR_GREEN_ 修改为: PeopleOfColorUnripe
define COLOR_PURE_ 修改为: GlossVirgin
define COLOR_RED_ 修改为: ColourCarmine
define COLOR_SELECTED_ 修改为: COLOR_SELECTED_
define COLOR_WHITE_ 修改为: COLOR_WHITE_
define COLOR_YELLOW_ 修改为: ColorationYellowness
define DEGREES 修改为: DEGREES
define DLog 修改为: DLog
define ENABLE_LOGGING_DEBUG 修改为: ENABLE_LOGGING_DEBUG
define ENABLE_LOGGING_INFO 修改为: ENABLE_LOGGING_INFO
define FBLogAnimDebug 修改为: FBLogarithmAnimDebug
define FBLogAnimInfo 修改为: FBLumberAnimInfo
define FloatConversion_h 修改为: FloatConversion_h
define LATO_10 修改为: LATO_10
define LATO_14 修改为: LatoXiv
define LATO_16 修改为: LATO_16
define LATO_BOLD 修改为: LatoSheer
define LATO_HAIRLINE 修改为: LatoHairline
define LATO_LIGHT 修改为: LATO_LIGHT
define LATO_REGULAR 修改为: LatoUnconstipated
define LATO_THIN 修改为: LATO_THIN
define LATO_THIN_IT 修改为: LATO_THIN_IT
define MIX 修改为: Coalesce
define NSLog 修改为: NSLog
define POPACTION_H 修改为: POPACTION_H
define POP_POPDefines_h 修改为: POP_POPDefines_h
define POP_POP_H 修改为: PopOutTonicH
define RADIAN 修改为: Rad
define SHOW_VIEW_WIDTH 修改为: EvidenceTakeInBreadth
define SIMPLE_NSLOG_H 修改为: RoundEyedNslogH
define THIS_FILE 修改为: ThisFileCabinet
define TIME_END_DURATION 修改为: TIME_END_DURATION
define TIME_NOR_DURATION 修改为: TIME_NOR_DURATION
define TITLE_MOVE_LABEL_HIDE_DURATION 修改为: TITLE_MOVE_LABEL_HIDE_DURATION
define TITLE_MOVE_LABEL_SHOW_DURATION 修改为: RubricRunPronounceShewDuration
define TransformationMatrix_h 修改为: TransformationMatrixH
define UPDATING_HEIGHY 修改为: UpdatingHeighy
define UnitBezier_h 修改为: UnitBezier_h
define WEATHER_TIME 修改为: WEATHER_TIME
define __Easing__Easing__ 修改为: ModerationRelief
define __POP__FBVector__ 修改为: __POP__FBVector__
define __state 修改为: Posit
define fbFriction 修改为: FbClash
define fbTension 修改为: FbStress
define qcFriction 修改为: QcFriction
define qcTension 修改为: QcTension
define stype 修改为: Stype
extern NetworkingNotReachableNotification 修改为: NetworkNotReachableApprisal
extern NetworkingReachableViaWIFINotification 修改为: NetworkReachableViaWiFiTelling
extern NetworkingReachableViaWWANNotification 修改为: NetworkReachableViaWWANTelling
extern POPAnimationDragCoefficient 修改为: BoltDownLivingHaleCoeff
extern POPAnimationGetState 修改为: POPAnimationGetState
extern POPBouncy3NoBounce 修改为: POPBouncy3NoBounce
extern POPBox 修改为: PopOutBoxSeat
extern POPCGColorGetRGBAComponents 修改为: POPCGColorGetRGBAComponents
extern POPCGColorRGBACreate 修改为: POPCGColorRGBACreate
extern POPCGColorWithColor 修改为: POPCGColorInWithColourIn
extern POPDictionaryCreateMutableWeakPointerToStrongObject 修改为: BulgeLexiconCreateMutableFallibleArrowToFirmAim
extern POPDictionaryCreateMutableWeakPointerToWeakPointer 修改为: BoltDownLexiconMakeMutableWeakCursorToWeaklyArrow
extern POPInterpolateVector 修改为: POPInterpolateVector
extern POPLayerGetRotation 修改为: SodaWaterLevelCauseRotation
extern POPLayerGetRotationX 修改为: POPLayerGetRotationX
extern POPLayerGetRotationY 修改为: POPYLayerCatchRevolution
extern POPLayerGetRotationZ 修改为: POPLayerGetRotationZ
extern POPLayerGetScaleX 修改为: POPXLayerGravelPlate
extern POPLayerGetScaleXY 修改为: POPXYLayerGravelPlate
extern POPLayerGetScaleY 修改为: POPYLayerArriveDescale
extern POPLayerGetScaleZ 修改为: POPZLayerArrestSurmount
extern POPLayerGetSubScaleXY 修改为: POPXYStratumBuzzOffGrinderScaleLeaf
extern POPLayerGetSubTranslationX 修改为: POPLayerGetSubTranslationX
extern POPLayerGetSubTranslationXY 修改为: POPLayerGetSubTranslationXY
extern POPLayerGetSubTranslationY 修改为: POPYStratumLetUBoatRendering
extern POPLayerGetSubTranslationZ 修改为: POPZStratumCauseStandInVersion
extern POPLayerGetTranslationX 修改为: POPXStratumStickVersion
extern POPLayerGetTranslationXY 修改为: POPXYLevelBringForthRendering
extern POPLayerGetTranslationY 修改为: POPLayerGetTranslationY
extern POPLayerGetTranslationZ 修改为: POPZBedBeatVersion
extern POPLayerSetRotation 修改为: POPLayerSetRotation
extern POPLayerSetRotationX 修改为: POPLayerSetRotationX
extern POPLayerSetRotationY 修改为: POPYLevelCongealRotation
extern POPLayerSetRotationZ 修改为: POPZBedAdjustGyration
extern POPLayerSetScaleX 修改为: POPLayerSetScaleX
extern POPLayerSetScaleXY 修改为: POPXYStratumReadinessScurf
extern POPLayerSetScaleY 修改为: POPYStratumFixedScurf
extern POPLayerSetScaleZ 修改为: POPZBedFitScurf
extern POPLayerSetSubScaleXY 修改为: POPXYStratumRigSubstituteScale
extern POPLayerSetSubTranslationX 修改为: POPLayerSetSubTranslationX
extern POPLayerSetSubTranslationXY 修改为: POPLayerSetSubTranslationXY
extern POPLayerSetSubTranslationY 修改为: POPLayerSetSubTranslationY
extern POPLayerSetSubTranslationZ 修改为: POPZLevelAdjustSubRendering
extern POPLayerSetTranslationX 修改为: POPLayerSetTranslationX
extern POPLayerSetTranslationXY 修改为: POPXYBedFitRendering
extern POPLayerSetTranslationY 修改为: POPYBedSethVersion
extern POPLayerSetTranslationZ 修改为: POPLayerSetTranslationZ
extern POPNSColorGetRGBAComponents 修改为: POPNSRGBAEmblazonReceivePart
extern POPNSColorRGBACreate 修改为: POPNSRGBAColourCreate
extern POPNormalize 修改为: POPNormalize
extern POPProjectNormal 修改为: PourDownVisualiseNormal
extern POPQuadraticOutInterpolation 修改为: PaQuadraticTabuInsertion
extern POPQuadraticSolve 修改为: POPQuadraticSolve
extern POPSelectValueType 修改为: DadChoiceRespectTypewrite
extern POPTimingFunctionSolve 修改为: POPTimingFunctionSolve
extern POPUIColorGetRGBAComponents 修改为: POPUIColorGetRGBAComponents
extern POPUIColorRGBACreate 修改为: POPUIRGBASemblanceMake
extern POPUnbox 修改为: POPUnbox
extern POPValueTypeToString 修改为: SodaPopPrizeTypeToStringUp
extern kPOPCollectionViewContentOffset 修改为: KPOPCollectingLookAtCapacitySetOff
extern kPOPCollectionViewContentSize 修改为: KPOPCollectionViewContentSize
extern kPOPLabelTextColor 修改为: KPOPPronounceTextColor
extern kPOPLayerBackgroundColor 修改为: KPOPStratumSettingVividness
extern kPOPLayerBorderColor 修改为: KPOPLayerBorderColor
extern kPOPLayerBorderWidth 修改为: KPOPLayerBorderWidth
extern kPOPLayerBounds 修改为: KPOPLayerThrottle
extern kPOPLayerCornerRadius 修改为: KPOPLayerCornerRadius
extern kPOPLayerOpacity 修改为: KPOPBedOpaqueness
extern kPOPLayerPosition 修改为: KPOPBedPut
extern kPOPLayerPositionX 修改为: KPOPLayerPositionX
extern kPOPLayerPositionY 修改为: KPOPYLevelSituation
extern kPOPLayerRotation 修改为: KPOPLayerRotation
extern kPOPLayerRotationX 修改为: KPOPXStratumRotation
extern kPOPLayerRotationY 修改为: KPOPYStratumRevolution
extern kPOPLayerScaleX 修改为: KPOPXLayerPlate
extern kPOPLayerScaleXY 修改为: KPOPXYLevelExfoliation
extern kPOPLayerScaleY 修改为: KPOPLayerScaleY
extern kPOPLayerShadowColor 修改为: KPOPStratumDarkColorise
extern kPOPLayerShadowOffset 修改为: KPOPBedShadeOffOutgrowth
extern kPOPLayerShadowOpacity 修改为: KPOPLayerShadowOpacity
extern kPOPLayerShadowRadius 修改为: KPOPLayerShadowRadius
extern kPOPLayerSize 修改为: KPOPLayerSize
extern kPOPLayerSubscaleXY 修改为: KPOPLayerSubscaleXY
extern kPOPLayerSubtranslationX 修改为: KPOPLayerSubtranslationX
extern kPOPLayerSubtranslationXY 修改为: KPOPXYLevelSubtranslation
extern kPOPLayerSubtranslationY 修改为: KPOPYLayerSubtranslation
extern kPOPLayerSubtranslationZ 修改为: KPOPLayerSubtranslationZ
extern kPOPLayerTranslationX 修改为: KPOPLayerTranslationX
extern kPOPLayerTranslationXY 修改为: KPOPLayerTranslationXY
extern kPOPLayerTranslationY 修改为: KPOPLayerTranslationY
extern kPOPLayerTranslationZ 修改为: KPOPZLayerTransformation
extern kPOPLayerZPosition 修改为: KPOPLayerZPosition
extern kPOPLayoutConstraintConstant 修改为: KPOPLayoutRestraintUnceasing
extern kPOPNavigationBarBarTintColor 修改为: KPOPNavigationBarBarTintColor
extern kPOPSCNNodeEulerAngles 修改为: KPOPSCNGuestEulerAngle
extern kPOPSCNNodeEulerAnglesX 修改为: KPOPSCNXNodeEulerAngle
extern kPOPSCNNodeEulerAnglesY 修改为: KPOPSCNNodeEulerAnglesY
extern kPOPSCNNodeEulerAnglesZ 修改为: KPOPSCNNodeEulerAnglesZ
extern kPOPSCNNodeOrientation 修改为: KPOPSCNLymphNodePreference
extern kPOPSCNNodeOrientationW 修改为: KPOPSCNNodeOrientationW
extern kPOPSCNNodeOrientationX 修改为: KPOPSCNXNodePreference
extern kPOPSCNNodeOrientationY 修改为: KPOPSCNNodeOrientationY
extern kPOPSCNNodeOrientationZ 修改为: KPOPSCNNodeOrientationZ
extern kPOPSCNNodePosition 修改为: KPOPSCNLymphNodePost
extern kPOPSCNNodePositionX 修改为: KPOPSCNXThickeningLay
extern kPOPSCNNodePositionY 修改为: KPOPSCNNodePositionY
extern kPOPSCNNodePositionZ 修改为: KPOPSCNZLymphNodeLocation
extern kPOPSCNNodeRotation 修改为: KPOPSCNNodeRotation
extern kPOPSCNNodeRotationW 修改为: KPOPSCNWKnobRotaryMotion
extern kPOPSCNNodeRotationX 修改为: KPOPSCNXKnobRotaryMotion
extern kPOPSCNNodeRotationY 修改为: KPOPSCNNodeRotationY
extern kPOPSCNNodeRotationZ 修改为: KPOPSCNZNodeRotaryMotion
extern kPOPSCNNodeScale 修改为: KPOPSCNLeafNodeGraduatedTable
extern kPOPSCNNodeScaleX 修改为: KPOPSCNXThickeningWeighingMachine
extern kPOPSCNNodeScaleXY 修改为: KPOPSCNNodeScaleXY
extern kPOPSCNNodeScaleY 修改为: KPOPSCNNodeScaleY
extern kPOPSCNNodeScaleZ 修改为: KPOPSCNZLymphGlandGraduatedTable
extern kPOPSCNNodeTranslation 修改为: KPOPSCNNodeTranslation
extern kPOPSCNNodeTranslationX 修改为: KPOPSCNNodeTranslationX
extern kPOPSCNNodeTranslationY 修改为: KPOPSCNYNodeTranslation
extern kPOPSCNNodeTranslationZ 修改为: KPOPSCNNodeTranslationZ
extern kPOPScrollViewContentInset 修改为: KPOPRollPurviewSubjectInsert
extern kPOPScrollViewContentOffset 修改为: KPOPScrollViewContentOffset
extern kPOPScrollViewContentSize 修改为: KPOPScrollViewContentSize
extern kPOPScrollViewScrollIndicatorInsets 修改为: KPOPScrollViewScrollIndicatorInsets
extern kPOPScrollViewZoomScale 修改为: KPOPScrollViewZoomScale
extern kPOPShapeLayerFillColor 修改为: KPOPShapeLayerFillColor
extern kPOPShapeLayerLineDashPhase 修改为: KPOPPatternLayerLineageShootPhaseAngle
extern kPOPShapeLayerLineWidth 修改为: KPOPShapeLayerLineWidth
extern kPOPShapeLayerStrokeColor 修改为: KPOPForgeLevelCVAColor
extern kPOPShapeLayerStrokeEnd 修改为: KPOPShapeLayerStrokeEnd
extern kPOPShapeLayerStrokeStart 修改为: KPOPShapeLayerStrokeStart
extern kPOPTabBarBarTintColor 修改为: KPOPTabletBlockOffStreakTingeColour
extern kPOPTableViewContentOffset 修改为: KPOPTableViewContentOffset
extern kPOPTableViewContentSize 修改为: KPOPRemitSentimentSubstanceSizing
extern kPOPToolbarBarTintColor 修改为: KPOPToolbarBarTintColor
extern kPOPViewAlpha 修改为: KPOPSightAlpha
extern kPOPViewAlphaValue 修改为: KPOPOpinionAlphaPrise
extern kPOPViewBackgroundColor 修改为: KPOPPanoramaDesktopDistort
extern kPOPViewBounds 修改为: KPOPViewBounds
extern kPOPViewBoundsRotation 修改为: KPOPLookAtTrammelGyration
extern kPOPViewCenter 修改为: KPOPSceneHeartAndSoul
extern kPOPViewFrame 修改为: KPOPSeeAnatomy
extern kPOPViewFrameCenterRotation 修改为: KPOPViewFrameCenterRotation
extern kPOPViewFrameRotation 修改为: KPOPViewFrameRotation
extern kPOPViewScaleX 修改为: KPOPXLookAtSurmount
extern kPOPViewScaleXY 修改为: KPOPXYTakeInMusicalScale
extern kPOPViewScaleY 修改为: KPOPYSceneDescale
extern kPOPViewSize 修改为: KPOPLookAtSize
extern kPOPViewTintColor 修改为: KPOPViewTintColor
extern kPOPWindowAlphaValue 修改为: KPOPWindowAlphaValue
extern kPOPWindowBackgroundColor 修改为: KPOPWindowBackgroundColor
extern kPOPWindowFrame 修改为: KPOPWindowFrame
protocol AbsNetworkingDelegate 修改为: IrisNetworkDesignate
protocol FailedLongPressViewDelegate 修改为: FlushItFarseeingAgitateConsiderDesignate
protocol GetWeatherDataDelegate 修改为: FixEndureDataPointDelegate
protocol LongTapAnimationViewDelegate 修改为: RetentiveWiretapAnimationWatchDelegate
protocol MapManagerLocationDelegate 修改为: MapHandlerLocatingAssign
protocol NetworkingDelegate 修改为: NetworkingDelegate
protocol NumberCountDelegate 修改为: NumberCountDelegate
protocol POPAnimationDelegate 修改为: PopBrioDelegate
protocol POPAnimatorDelegate 修改为: POPAnimatorDelegate
protocol POPAnimatorObserving 修改为: POPAnimatorObserving
protocol PressAnimationButtonDelegate 修改为: PressAnimationButtonDelegate
protocol SearchViewDelegate 修改为: HuntingReckonAssign
protocol TWMessageBarStyleSheet 修改为: TWMessageBlockUpTitleSail
protocol TWMessageViewDelegate 修改为: TWSubstanceSightDesignate
protocol TapTitleViewDelegate 修改为: TapTitleViewDelegate
protocol WeatherViewDelegate 修改为: WeatherViewDelegate
static CATransactionCommitRunLoopOrder 修改为: CalciumDealingIntrustRillGrummetSetUp
static POPAnimationApplyRunLoopOrder 修改为: BulgeLivingGiveEscapeIntertwineArrange
static POPBouncy3BouncinessNormalizedMax 修改为: POPBouncy3BouncinessNormalizedMax
static POPBouncy3BouncinessNormalizedMin 修改为: POP3SpringyBounceNormalizeTaiwanese
static POPBouncy3FrictionInterpolationMax 修改为: POP3PeppyDetritionInsertionScoop
static POPBouncy3NormalizationRange 修改为: POP3BouncingStandRove
static POPBouncy3NormalizationScale 修改为: POP3ResilientNormaScurf
static POPBouncy3SpeedNormalizedMax 修改为: POPBouncy3SpeedNormalizedMax
static POPBouncy3SpeedNormalizedMin 修改为: POP3LivelyHastenNormalizeFukien
static _animator 修改为: Animator
static _disableBackgroundThread 修改为: DisableBackgroundWind
static _displayTimerFrequency 修改为: _displayTimerFrequency
static appIdKey 修改为: AppIdPrimal
static func 修改为: Func
static instance 修改为: Representative
static kDisplayTimerFrequency 修改为: KibibyteExhibitTimerFrequency
static kPOPAnimationDecayDecelerationDefault 修改为: KPOPAnimationDecayDecelerationDefault
static kPOPAnimationDecayMinimalVelocityFactor 修改为: KPOPAnimationDecayMinimalVelocityFactor
static kPOPAnimationDurationDefault 修改为: KPOPAnimationDurationDefault
static kPOPProgressThreshold 修改为: KPOPWorkUpThreshold
static kPOPThresholdColor 修改为: KPOPBrinkVividness
static kPOPThresholdOpacity 修改为: KPOPDoorstepOpacity
static kPOPThresholdPoint 修改为: KPOPBrinkIndicate
static kPOPThresholdRadius 修改为: KPOPThresholdR
static kPOPThresholdRotation 修改为: KPOPThresholdRotation
static kPOPThresholdScale 修改为: KPOPThresholdScale
static kTWDefaultMessageBarStyleSheetErrorBackgroundColor 修改为: KTWDefaultMessageBarStyleSheetErrorBackgroundColor
static kTWDefaultMessageBarStyleSheetErrorStrokeColor 修改为: KTWDefaultContentBARDashCanvasFaultStrokeGloss
static kTWDefaultMessageBarStyleSheetInfoBackgroundColor 修改为: KTWDefaultMessageBarStyleSheetInfoBackgroundColor
static kTWDefaultMessageBarStyleSheetInfoStrokeColor 修改为: KTWDefaultMessageBanishDashRagInfoSlashColour
static kTWDefaultMessageBarStyleSheetSuccessBackgroundColor 修改为: KTWDefaultMessageBarStyleSheetSuccessBackgroundColor
static kTWDefaultMessageBarStyleSheetSuccessStrokeColor 修改为: KTWDefaultMessageExcludeDashBedSheetAchieverCVATinge
static kTWMessageViewDescriptionColor 修改为: KTWSubstanceRegardDescrTinge
static kTWMessageViewDescriptionFont 修改为: KTWMessageViewDescriptionFont
static kTWMessageViewTitleColor 修改为: KTWSubstanceSurveyRubricColoration
static kTWMessageViewTitleFont 修改为: KTWMessageViewTitleFont
static onceToken 修改为: OnceToken
static pred 修改为: Pred
static staticProp 修改为: ElectrostaticPropUp
头文件 AddedFont 修改为: ContributeBaptistry
头文件 AppColor 修改为: AppColor
头文件 Easing 修改为: Facilitate
头文件 FloatConversion 修改为: FloatConversion
头文件 GCD 修改为: GCD
头文件 POP 修改为: ComeOut
头文件 POPAction 修改为: SodaActivity
头文件 POPAnimatablePropertyTypes 修改为: PopMusicAnimatableHoldingEccentric
头文件 POPAnimationEventInternal 修改为: BulgeOutLivingOutcomeNational
头文件 POPAnimationInternal 修改为: PappaLifeInner
头文件 POPAnimationPrivate 修改为: PoppingVivificationBuckPrivate
头文件 POPAnimationTracerInternal 修改为: POPAnimationTracerInternal
头文件 POPAnimatorPrivate 修改为: POPAnimatorPrivate
头文件 POPBasicAnimationInternal 修改为: CropUpCanonicAnimationIntragroup
头文件 POPDecayAnimationInternal 修改为: POPDecayAnimationInternal
头文件 POPDefines 修改为: POPDefines
头文件 POPPropertyAnimationInternal 修改为: POPPropertyAnimationInternal
头文件 POPSpringAnimationInternal 修改为: POPSpringAnimationInternal
头文件 POPSpringSolver 修改为: CropUpRecoilProblemSolver
头文件 SimpleNSLog 修改为: SimpleNSLog
头文件 TransformationMatrix 修改为: ShiftGroundSubstance
头文件 UnitBezier 修改为: UnitBezier
头文件 YoCelsius 修改为: YoCelsius
属性 HTTPHeaderFieldsWithValues 修改为: hTTPHeaderFieldsWithValues
属性 addMoreCity 修改为: sumMoreCity
属性 alphaArray 修改为: alphaRaiment
属性 alphaView 修改为: alphaRegard
属性 animate 修改为: invigorate
属性 animationColor 修改为: spiritednessColor
属性 animationHasVelocity 修改为: brioHAVelocity
属性 animationState 修改为: spiritednessStateOfMatter
属性 animtedImageView 修改为: animtedPictureConsider
属性 baseLabel 修改为: rootWordPronounce
属性 baseLabelStoreValue 修改为: rootTagPutInValue
属性 blackView 修改为: lightlessnessProspect
属性 canTouch 修改为: stoolRelate
属性 cellHeight 修改为: electricCellPeak
属性 centerLineView 修改为: substanceMelodicLineOpinion
属性 centerLineViewStoreValue 修改为: rivetCreaseRegardPutInPrise
属性 changeColorLabel 修改为: changeColourationMark
属性 circleByOneSecond 修改为: roundPastPeerlessSecondBase
属性 circleView 修改为: roundaboutTakeIn
属性 cityId 修改为: urbanCenterGemState
属性 cityName 修改为: cityAppoint
属性 cityNameLabel 修改为: cityPublicFigurePronounce
属性 cityNameLabelStoreValue 修改为: metropolisEpithetTagEntrepotPrise
属性 clockWise 修改为: timeJudicious
属性 cod 修改为: gull
属性 completeDurationAfterLongPress 修改为: completeLengthAfterwardsFarsightedPush
属性 conutAnimation 修改为: conutSpiritedness
属性 countLabel 修改为: matterJudge
属性 countryCodeBackgroundView 修改为: ruralAreaCodeSettingSentiment
属性 currentConditions 修改为: streamSpecify
属性 currentLocation 修改为: streamPosition
属性 currentWeatherData 修改为: flowWeatherDatum
属性 dateLabel 修改为: goOutRecordingLabel
属性 defaultTransform 修改为: nonpaymentTransform
属性 descriptionInfo 修改为: descriptionInformation
属性 dispatchGroup 修改为: expeditionGroup
属性 dispatchQueue 修改为: hitQueue
属性 dispatchSemaphore 修改为: shipmentSemaphore
属性 dispatchSource 修改为: dischargeAuthor
属性 displayLink 修改为: presentationLink
属性 downCenterRect 修改为: downcastFocusRect
属性 downView 修改为: dispiritedVista
属性 endRect 修改为: finishRect
属性 fadeToHideDuration 修改为: blowOverToEnshroudLength
属性 fadeToShowDuration 修改为: meltToPointDuration
属性 failedLabel 修改为: failRecordingLabel
属性 failedLabelStoreValue 修改为: bombLabelStackAwayPrize
属性 forecastLabel 修改为: forecastTag
属性 frameArray 修改为: materialBodyAlign
属性 fullCircle 修改为: entireEncircle
属性 gapFromBottom 修改为: disruptionFromBuns
属性 gapFromLeft 修改为: interruptionFromGive
属性 gapFromTop 修改为: openingFromUpperSide
属性 gradientLayer 修改为: slopeLevel
属性 grayLine3 修改为: gyBloodLineTrio
属性 gridView 修改为: gridironPurview
属性 grnd_level 修改为: grndTier
属性 hasCallback 修改为: ingestCallback
属性 highlightLabel 修改为: highSpotPronounce
属性 highlightTextColor 修改为: highlightingTextualMatterColouring
属性 humidity 修改为: humidness
属性 humidityView 修改为: humidnessTakeIn
属性 iconViewStoreValue 修改为: ikonSeeStorageRate
属性 labelWidth 修改为: recordingLabelWidth
属性 line 修改为: telephoneLine
属性 lineBackgroundView 修改为: melodicPhraseBackgroundPerspective
属性 lineColor 修改为: bloodLineSemblance
属性 lineGap 修改为: bloodCol
属性 lineStoreValue 修改为: dividingLineStockTimeValue
属性 lineView 修改为: lineOfCreditVista
属性 maxCountViewStoreValue 修改为: goopCountingLookAtMemoryAppraise
属性 maxTempLabel 修改为: maxTemporaryWorkerTag
属性 maxTempView 修改为: soapTemporaryConsider
属性 menu 修改为: computerMenu
属性 menuButton 修改为: fareButton
属性 messageBarQueue 修改为: contentRelegateLineUp
属性 messageType 修改为: subjectMatterTypewrite
属性 midFrame 修改为: midPhysique
属性 min 修改为: amoy
属性 minTemp 修改为: minTemporary
属性 minTempCount 修改为: amoyTemporaryNumeration
属性 moonImageView 修改为: sunMyungMoonRangeRegard
属性 moonImageViewStoreValue 修改为: moonOnIconCatchStoreTreasure
属性 moveGap 修改为: affectCol
属性 movetitleLabel 修改为: movetitleMark
属性 networkDaily 修改为: netEveryday
属性 networkWeather 修改为: networkConditions
属性 networkingInfo 修改为: networkInformation
属性 networkingInfomation 修改为: networkInfomation
属性 night 修改为: nighttime
属性 normalColor 修改为: conventionColouration
属性 normalLabel 修改为: patternTag
属性 normalTextColor 修改为: patternTextbookVividness
属性 observers 修改为: percipient
属性 oneLine 修改为: unityStemma
属性 originalResponseData 修改为: masterCopyReceptionData
属性 pendingListObserver 修改为: pendingHeelPercipient
属性 population 修改为: universe
属性 pressButton 修改为: closetRelease
属性 readBlock 修改为: understandFreeze
属性 redView 修改为: violentSentiment
属性 redViewStoreValue 修改为: cherryProspectEntrepotNoteValue
属性 requestBodyType 修改为: requestDeadBodyCharacter
属性 requestParameter 修改为: callForArgument
属性 responseDataManager 修改为: receptionInformationDirector
属性 responseDataType 修改为: answerDataEccentric
属性 rotateView 修改为: revolveSight
属性 scaleValue 修改为: orderedSeriesPrize
属性 sea_level 修改为: seaTakeDown
属性 serviceInfo 修改为: overhaulInfo
属性 shapeLayer 修改为: bodLayer
属性 shouldLogAndResetOnCompletion 修改为: shouldLumberAndResetOnWindup
属性 showCircle 修改为: bearWitnessRoofy
属性 showDownView 修改为: appearanceDownInTheMouthRegard
属性 showView 修改为: demoConsider
属性 snowImage 修改为: blowSee
属性 speedRange 修改为: speedUpPlace
属性 startFrame 修改为: protrudeFraming
属性 startRect 修改为: startOutRect
属性 staticImageView 修改为: staticSeePosition
属性 sunImageView 修改为: sunVisualizeCatch
属性 sunImageViewStoreValue 修改为: solarizeRangeSeeStoragePrise
属性 sunInfoView 修改为: sunInfoSurvey
属性 sunriseViewStoreValue 修改为: dawningReckonStockValuate
属性 sunsetValue 修改为: sundownValue
属性 sunsetView 修改为: sundownConsider
属性 sunsetViewStoreValue 修改为: sunsetSurveyEntrepotNoteValue
属性 sunsireValue 修改为: sunsireAppraise
属性 temp_max 修改为: temporaryWorkerLiquidEcstasy
属性 temperatureCount 修改为: temperatureLook
属性 textLabelFrame 修改为: textEditionJudgeUnderframe
属性 threeLineView 修改为: terzettoCrinkleEyeshot
属性 threshold 修改为: doorway
属性 titleMoveLabel 修改为: formOfAddressAffectMark
属性 underLineColor 修改为: netherTraceColorise
属性 underlineViewFrame 修改为: underscorePanoramaFrame
属性 upCenterRect 修改为: improvingShoppingCentreRect
属性 upView 修改为: upOpinion
属性 updateYearLabelStoreValue 修改为: updateClassLabelDepotMeasure
属性 uploadProgressBlock 修改为: uploadGetOnOcclude
属性 urlString 修改为: uRLThread
属性 utcSec 修改为: uTCSEC
属性 vLine 修改为: cinqueStrain
属性 weatherDataArray 修改为: braveDataPointArray
属性 weatherDesLabel 修改为: braveOutDESTag
属性 weatherIconView 修改为: endureIconLookAt
属性 weatherId 修改为: conditionsID
属性 weatherInfoLabel 修改为: weatherInfoMark
属性 weatherNumber 修改为: upwindIssue
属性 weatherUpdateTime 修改为: braveUpdateMeter
属性 windCountLabelStoreValue 修改为: tipCountLabelShopAppraise
属性 windSpeedCount 修改为: wrapBucketAlongEnumeration
属性 windSpeedView 修改为: airCurrentAccelerateView
属性 writeBlock 修改为: dropALineBlockOff
方法 LineWidth 修改为: assemblyLineBreadth
方法 _advance 修改为: gainGround
方法 _appendDescription 修改为: affixDescription
方法 _clearPendingListObserver 修改为: percipientPendingTiltPercipient
方法 _currentRenderTime 修改为: streamGivePrisonTerm
方法 _scheduleProcessPendingList 修改为: docketOperationPendingListing
方法 _updatedDynamicsFriction 修改为: updateDynamicRubbing
方法 _updatedDynamicsMass 修改为: updateDynamicRaft
方法 accessNumber 修改为: getAtTurn
方法 activateButtonEffect 修改为: setOffReleaseForce
方法 allEvents 修改为: totallyUpshot
方法 animationForObject 修改为: animationForObjective
方法 animationWithBlock 修改为: livelinessWithFreeze
方法 animationWithCustomPropertyNamed 修改为: livelinessWithImpostAttributeIdentify
方法 animationWithCustomPropertyReadBlock 修改为: livingWithImpostAttributeSayImpede
方法 animationWithPropertyNamed 修改为: brioWithDimensionDescribe
方法 buildView 修改为: materialBodyAspect
方法 buildViews 修改为: physiqueCatch
方法 buttonTouchDownAndDragEnter 修改为: releaseTinctDowncastAndSweepInsert
方法 buttonTouchDragExit 修改为: pushButtonTouchingTrailSnuffIt
方法 calculateFrameFromValue 修改为: aimShapeFromTreasure
方法 cancelRequest 修改为: offsetBespeak
方法 configType 修改为: configTypecast
方法 convertBounciness 修改为: convinceBounce
方法 convertTension 修改为: exchangeLatentHostility
方法 createButtonWithFrame 修改为: producePushButtonWithInning
方法 createDefaultViewWithFrame 修改为: createDefaultOnConsiderWithPhysique
方法 createLabelsWithFrame 修改为: makeLabelWithAnatomy
方法 createViewWithFrame 修改为: makeViewWithFrameIn
方法 createWithText 修改为: createWithTextbook
方法 currentSting 修改为: streamBite
方法 currentValue 修改为: streamNoteValue
方法 defaultAnimation 修改为: defaultOnAnimation
方法 delaySecs 修改为: delayS
方法 destroy 修改为: putDown
方法 didChangeDeviceOrientation 修改为: executeChangeGimmickPreference
方法 didUpdateLocations 修改为: serveUpdateFix
方法 durationForMessageType 修改为: durationForSubstanceType
方法 easeInAnimation 修改为: easeAtomicNumberVivification
方法 easeInEaseOutAnimation 修改为: relaxationInwardsRelieveAwayAliveness
方法 easeOutAnimation 修改为: alleviateTabooVitality
方法 enter 修改为: getInto
方法 eventDidBecomeActive 修改为: upshotManageSuitActive
方法 eventsWithType 修改为: upshotWithEccentric
方法 executeInGlobalQueue 修改为: putToDeathIndianaOrbicularQueueUp
方法 executeInHighPriorityGlobalQueue 修改为: putToDeathInEminentPrecedencyWorldwideQueueUp
方法 fadeTohide 修改为: evanesceTohide
方法 fontTextWeatherNumber 修改为: baptisteryTextbookWeatherBit
方法 frameCount 修改为: skeletonReckoning
方法 frameFrom 修改为: borderFrom
方法 getMethodNetworkingWithUrlString 修改为: methodNetworkWithURLStrin
方法 getSystemFontList 修改为: systemOfRulesBaptistryLithium
方法 hideAllAnimated 修改为: hideCompletelyAnimated
方法 hideDuration 修改为: obscureLength
方法 hideWithDuration 修改为: coverWithContinuance
方法 highPriorityGlobalQueue 修改为: gameyPrecedenceSphericQueueUp
方法 iconColor 修改为: pictureColourize
方法 iconImageForMessageType 修改为: iconVisualizeForContentType
方法 initConcurrent 修改为: initConcurre
方法 initConcurrentWithLabel 修改为: initConcurrentWithLabel
方法 initInQueue 修改为: initInQueue
方法 initLabel 修改为: initTag
方法 initLabels 修改为: initLabels
方法 initLineViews 修改为: initLineViews
方法 initRects 修改为: initRects
方法 initSerial 修改为: initSerial
方法 initSerialWithLabel 修改为: initSeriesWithMark
方法 initSnow 修改为: initSnow
方法 initTableView 修改为: initTableView
方法 initUnderLine 修改为: initUnderLine
方法 initViews 修改为: initSee
方法 initWithAnimation 修改为: initWithAnimatio
方法 initialize 修改为: initAlize
方法 initializer 修改为: initAlizer
方法 kern 修改为: jeromeKern
方法 linearAnimation 修改为: analogInvigoration
方法 longPressCompleteWithView 修改为: yearnCrushConsummateWithSentiment
方法 longPressPercentage 修改为: farsightedMilitaryPressShare
方法 lowPriorityGlobalQueue 修改为: abjectPrioritySphericLineUp
方法 messageWindowView 修改为: subjectMatterWindowpaneCatch
方法 moveDistance 修改为: motilityOutdistance
方法 networkingRequestFailed 修改为: networkAskingNeglect
方法 networkingRequestSucess 修改为: networkRequestSucess
方法 networkingWithNetworkConfig 修改为: networkWithWebConfig
方法 networkingWithUrlString 修改为: networkWithURLDrawstring
方法 numberCount 修改为: telephoneNumberCounting
方法 originalVelocity 修改为: pilotVelocity
方法 paragraphStyle 修改为: paragraphElan
方法 percent 修改为: perCentum
方法 pop_animationDidApply 修改为: downAnimationComeImplement
方法 postMethodNetworkingWithUrlString 修改为: stakeMethodNetworkWithURLDrawstring
方法 readPropertyValue 修改为: translatePlaceTimeValue
方法 refreshPeriod 修改为: refreshStop
方法 remove 修改为: getRidOf
方法 renderTime 修改为: forkOutFourthDimension
方法 requestSuccess 修改为: postulationWinner
方法 resetImageView 修改为: resetFigureThought
方法 reversedVelocity 修改为: vacateSpeed
方法 rotateImageViewWithCircleByOneSecond 修改为: splayEpitomeConsiderWithBandAwayBack
方法 scaleAnimations 修改为: orderedSeriesAnimation
方法 scaleToDefault 修改为: weighingMachineToDefaultOn
方法 scaleToSmall 修改为: exfoliationToModest
方法 serializeRequestParameter 修改为: serializeCallForParameter
方法 setAnimationDidApplyBlock 修改为: animationDidApplyBlock
方法 setAnimationDidReachToValueBlock 修改为: animationBehaveProgressToToAppraiseOcclusion
方法 setAnimationDidStartBlock 修改为: animationDidStartBlock
方法 setClampMode 修改为: clinchModern
方法 setDeceleration 修改为: slowing
方法 setDynamicsFriction 修改为: dynamicsFriction
方法 setDynamicsMass 修改为: kineticsArtiumMagister
方法 setDynamicsTension 修改为: dynamicsTension
方法 setEmitterLayer 修改为: emitterBed
方法 setProgressMarkers 修改为: progressMarker
方法 setRepeatForever 修改为: iterateEternally
方法 setRoundingFactor 修改为: assaultFactorOut
方法 setShouldLogAndResetOnCompletion 修改为: shouldLogAndResetOnCompletion
方法 setSolver 修改为: solver
方法 setSpringBounciness 修改为: takeFormBouncin
方法 setSpringSpeed 修改为: springinessSwiftness
方法 setSunset 修改为: sunshine
方法 setSunsetTimeLabel 修改为: sunsetTimeLabel
方法 setSunsetValue 修改为: sunsetValu
方法 setSunsetView 修改为: sunsetView
方法 setSunsetViewStoreValue 修改为: sunsetViewStoreValu
方法 setup 修改为: astir
方法 showDuration 修改为: renderContinuance
方法 showMessage 修改为: depictSubjectMatter
方法 showMessageWithTitle 修改为: registerContentWithEntitle
方法 showNetworkActivityIndicator 修改为: evinceNetworkActionIndex
方法 showPercent 修改为: evidencePct
方法 showSnow 修改为: establishC
方法 showWithDuration 修改为: appearanceWithLength
方法 startGetLocationWeatherData 修改为: takeOffGetPlacementUpwindDataPoint
方法 startRequest 修改为: takeUpPetition
方法 statusBarOffset 修改为: statusGinmillStolon
方法 strikethroughStyle 修改为: strikethroughManner
方法 strokeWidth 修改为: diagonalBreadth
方法 systomFontNameList 修改为: systomTypefaceIdentifyHeel
方法 timeIntervalWithSecs 修改为: metreIntervalWithSecond
方法 titleFont 修改为: deedCase
方法 titleSize 修改为: claimSizing
方法 toBounciness 修改为: toBounce
方法 updateFromValue 修改为: updateFromValuate
方法 updateLabelView 修改为: updateTagCatch
方法 updateMass 修改为: updateHoiPolloi
方法 updateSpeed 修改为: updateHasten
方法 waitExecute 修改为: waitressAction
方法 withStoreValue 修改为: withLayInValue
方法 writePropertyValue 修改为: publishPropertyEvaluate
枚举 DecomposedType 修改为: DecomposedType
枚举 EMitterType 修改为: EMitterType
枚举 ENetworkingMethod 修改为: TocopherolNetworkMethod
枚举 ESearchView 修改为: ESearchView
枚举 EnumFrameView 修改为: EnumFrameView
枚举 POPAnimationClampFlags 修改为: SodaPopAlivenessClinchSwag
枚举 POPAnimationEventType 修改为: PourDownAnimationCaseType
枚举 POPAnimationType 修改为: POPAnimationType
枚举 POPProgressMarker 修改为: DrinkDownGoOnMarking
枚举 POPValueType 修改为: PopOutRateCase
枚举 TWMessageBarMessageType 修改为: TWMessageBarMessageType
类名 AbsNetworking 修改为: IrisNetwork
类名 AbsRequestParameterSerializer 修改为: IrisRequestArgumentSerializer
类名 AlphaView 修改为: AlphaPerspective
类名 ChangeColorLabel 修改为: ExchangeColourizeTag
类名 CircleView 修改为: ForgetMeDrugScene
类名 CityTitleView 修改为: MetropolisDeedPerspective
类名 FadeBlackView 修改为: BlowOverPitchBlackView
类名 FailedLongPressView 修改为: GiveOutLongPushHorizon
类名 FontInfomation 修改为: TypefaceInfomation
类名 ForecastController 修改为: PrognosisAccountant
类名 GCDGroup 修改为: GCDGrouping
类名 GCDTimer 修改为: GCDTimekeeper
类名 GetWeatherData 修改为: BuzzOffBraveOutInformation
类名 HumidityCount 修改为: HumidnessMatter
类名 HumidityCountLabel 修改为: HumidnessConsiderMark
类名 HumidityView 修改为: HumidityPanorama
类名 LabelView 修改为: RecordingLabelHorizon
类名 LineAnimationView 修改为: LineOfProductsInvigorationEyeshot
类名 LineBackgroundView 修改为: BloodlineBackgroundLookAt
类名 MaxTempCount 修改为: GoopTemporaryNumber
类名 MaxTempCountLabel 修改为: SoapTempCountingMark
类名 MinTempContLabel 修改为: TaiwaneseTempContTag
类名 Networking 修改为: Network
类名 POPAnimationEvent 修改为: BoltDownLifeIssue
类名 POPAnimationTracer 修改为: DrinkDownAnimationTracerBullet
类名 POPMutableAnimatableProperty 修改为: SodaMutableAnimatableDimension
类名 POPPlaceholderAnimatableProperty 修改为: StartProxyAnimatableDimension
类名 POPPropertyAnimation 修改为: TossOffAttributeLiving
类名 PostMethod 修改为: CWPostMethod
类名 RequestParameterSerializer 修改为: CallForParameterSerializer
类名 SearchView 修改为: ResearchLookAt
类名 ShapeWordView 修改为: MoldParolePurview
类名 ShowDownView 修改为: PresentDownwardsSee
类名 SunriseAndSunset 修改为: BreakOfTheDayAndSunset
类名 SunsetViewStoreValue 修改为: SundownConsiderStockTreasure
类名 TWMessageBarManager 修改为: TWContentBarDirector
类名 TWMessageView 修改为: TWSubjectMatterScene
类名 Temp 修改为: Temporary
类名 TemperatureCountLabel 修改为: TemperatureReckonTag
类名 ThreeLineView 修改为: LeashMelodicLineWatch
类名 UpdatingView 修改为: UpdateRegard
类名 Weather 修改为: Brave
类名 WeatherIconView 修改为: WeatherImageSentiment
类名 WeatherIconViewStoreValue 修改为: EndurePictureLookAtFundAppreciate
类名 WeatherNumberMeaningTransform 修改为: WeatherActHaveInMindTransmute
类名 WeatherTitleView 修改为: BraveTitleOfRespectPanorama
类名 WeatherTitleViewStoreValue 修改为: EndureDeedWatchShopEsteem
类名 Wind 修改为: WindInstrument
类名 WindSpeedCount 修改为: WindSpeedNumerate
